111111111111111111
1P0C000000000000E1
111111111111111111
